{
    "18": 1,
    "17": 2,
    "16": 3,
    "15": 4,
    "14": 5,
    "13": 6,
    "12": 7,
    "10": 8,
    "9": 9,
    "7": 10,
    "6": 11,
    "5": 12,
    "4": 13,
    "3": 14,
    "2": 15
}